name	seq
MPXV_1_LEFT	AGCAGTGTCCCCTACATGGATT
MPXV_1_RIGHT	AGGAGCATCAGGGTGTAGAACA
MPXV_3_LEFT	AATCTGGAAGCGTAAGTTCCCG
MPXV_3_RIGHT	CGAGATTGTGCGCATCGTTAAC
MPXV_5_LEFT	ACCTGCTCGGTTACTTCTGTGT
MPXV_5_RIGHT	TGAGAGCGAGAGTGACAGTGAT
MPXV_10_LEFT	AGCTAAACCCAGGCATACGTTC
MPXV_10_RIGHT	TGAGGAGGTGGTTCTCGATGAA
MPXV_16_LEFT	TCAAGTGGTGGGGATCCATAGT
MPXV_16_RIGHT	TATCCGACGGTCCATTGCTAGA
MPXV_27_LEFT	ATAACCGGCGCTGTCATGTATC
MPXV_27_RIGHT	GGATGAATCCGAAGCACGTGTA
MPXV_28_LEFT	TCCTCTGTGGCTAGCGCTATAA
MPXV_28_RIGHT	GACTTTTCCCAAGTGGCTGGAA
MPXV_64_LEFT	GGTGGCGCTAGTCATCACATTA
MPXV_64_RIGHT	TGGGTTCTTGAAGAGGGCTAGA
MPXV_111_LEFT	TTCGAATTCACGGGGTACAACC
MPXV_111_RIGHT	AACCACATGCTACTGGAGGAGA
MPXV_124_LEFT	ATCCACTAGAGCAGCCGTATGA
MPXV_124_RIGHT	ATCCCTGACAAGTTCCTGGAGT
MPXV_131_LEFT	CCAACCATGTACCGTCGAGTTA
MPXV_131_RIGHT	TTGGTTCCGGAGTCGTGATTTC
MPXV_149_LEFT	CCAGGCTCTCGCATAAAGATGA
MPXV_149_RIGHT	GGGCGGAATAACGGGAATGTAA
